timerglobal 250
timerfantome 20

CCCCCCCCCCCCCCCCCCCCC
CP      CCC         C
C C C C C C C C C C C
C MMMMMMMMMMMMMMMMM C
C CMCMCMCMCMCMCMCMC C
C MMMMMMMMMMMMMMMMM C
C CMCMCMCMCMCMCMCMC C
C MMMMMMMMMMMMMMMMM C
C CMCMCMCMCMCMCMCMC C
C MMMMMMMMMMMMMMMMM C
C CMCMCMCMCMCMCMCMC C
CCC               CCC
C CMCMCMCMCMCMCMCMC C
C MMMMMMMMMMMMMMMMM C
C CMCMCMCMCMCMCMCMC C
C MMMMMMMMMMMMMMMMM C
C CMCMCMCMCMCMCMCMC C
C MMMMMMMMMMMMMMMMM C
C CMCMCMCMCMCMCMCMC C
C       CCC        PC
CCCCCCCCCCCCCCCCCCCCC