timerglobal 500
timerfantome 1000

CCCCCCCCCCCCCCCCCCCCC
C P     CCC         C
C C C C C C C C C C C
CCMMMMMMMMMMMMMMMMM C
C  CCCCCCCCCCCCCCCCCC
C MMMMMMMMMMMMMMMMMCC
C CMCMCMCMCMCMCMCMC C
C MMMMMMMMMMMMMMMMM C
CCCCCCCCCCCCCCCCCCCCC