timerglobal 500
timerfantome 20

CCCCCCCCCCCCCCCCCCCCC
C P               E C
C C C C C C C C C C C
C MMMMMMMMMMMMMMMMM C
CCCCCCCCCCCCCCCCCCCCC
